####################
#..................#
#..................#
#..................#
#..................#
#..................#
#..........C.......#
#..................#
#..................#
#..................#
#....C...#C#C#.....#
#................G.#
#.@................#
#......X...........#
####################
