####################
#..................#
#................G.#
#..................#
#................###
#...................
#...................
#.............___...
#...................
#...................
#............X......
#....__....###......
#.@........#.......#
#.......XX....XX...#
####################
