####################
#..................#
#..................#
#..................#
#...XX.......##....#
####..##XXX....XXXX#
#..................#
#..................#
#.@...............G#
#..................#
####XXXX##.....##..X
#.........XXXXX..XX#
#..................#
#..................#
####################
