####################
#..................#
#.@..C..C..C.......#
#..................#
######..#..#.......#
#....X..X..........#
#....X..XXX........#
#....X..X..........#
#....X..X..........#
#....X.#x..........#
#....X.............#
#....X.............#
#.....G............#
#..................#
####################
