####################
#....#.............#
#....#.G...........#
#....#.............#
#....#######__.....#
#..................#
#..................#
#..................#
#..................#
#....#.....#.....###
#....X.....#.......#
#....X.....#.......#
#.@..#.....#.......#
#....#.....#XX.....#
######.....#########
